WE       assets/wwall.xpm

     NO assets/nwall.xpm

F 255,255,0

SO assets/swall.xpm


EA assets/ewall.xpm

C     255 ,0 ,255                               


        111111111111111111111111111
        110011000000011000000000001
        11011000001110000000000N011
        10010000000000000000000001
111111111011000001110000000000001
100000000011000001110111111111111
11110111111111011100000010001
11110111111111011101010010001
11000000000000000000000010001
10000000000000000000000010001
100000000000010001101010010001
110000011101010111110111101111
11110111 1110001 101111000101
11111111 1111111 111111111111     
