WE       assets/wwall.xpm

     NO assets/nwall.xpm

F 220,100,10

SO assets/swall.xpm


EA assets/ewall.xpm

C     100  ,30,0

        111111111111111111111111111
        110011000000011000000000001
        110110000011100000000000011
        1001000000000000000000001
111111111011000001110000000000001
100000000011000001110111111111111
11110111111111011100000010001
11110111111111011101010010001
110000000N0000000000000010001
10000000000000000000000010001
100000000000010001101010010001
110000011101010111110111101111
11110111 1110001 101111000101
11111111 1111111 111111111111